BBBBBBBBBB
BBBBBBBBBB
BBBBBBBBBB
BBRRRRRRBB
BBRRRRRRBB
BBRRRRRRBB
BBKKKKKKBB
BBKKKKKKBB
BBKKKKKKBB
BBKKKKKKBB
BBRRRRRRBB
BBRRRRRRBB
BBRRRRRRBB
BBBBBBBBBB
BBBBBBBBBB
BBBBBBBBBB
