BBBBBBBBBB
BBBBBBBBBB
KKKKKKKKKK
KBBBBBBBBK
KBRRRRRRBK
KBRKKKKRBK
KBRKRRKRBK
KBRKRRKRBK
KBRKRRKRBK
KBRKRRKRBK
KBRKKKKRBK
KBRRRRRRBK
KBBBBBBBBK
KKKKKKKKKK
BBBBBBBBBB
BBBBBBBBBB
