BBBRRBRRBB
BBRRBBBRRB
BRRBBKBBRR
RRBBKKKBBR
RBBKKBKKBB
RBKKBRBKKB
RBBKKBKKBB
RRBBKKKBBR
BRRBBKBBRR
BBRRBBBRRB
BBBRRBRRBB
KBBBRRRBBB
KKBBBRBBBK
BKKBBBBBKK
BBKKBBBKKB
BBBKKBKKBB
