RRBBBKKKBB
RRBBBKKKBB
RRBBBKKKBB
RRBBBKKKKK
RBBBBKRRKK
RKKRRKRRKK
RKKRRKRRKK
RKKRRKKKKK
RBBRRKKKKK
KKBRRKRRBB
KKBRRKRRBB
KKBRRKRRBB
KRRBBKBBRR
KRRBBKBBRR
KRRBBKBBRR
KKKKKKBBRR
