BBBBBBBBBB
BBBBBBBBBB
BBBBBBBBBB
BBBRRRRRRR
BBBRRRRRRR
BBBRRKKKKK
BBBRRKKKKK
BBBRRKKBBB
BBBRRKKBBB
BBBRRKKBBB
BBBRRKKBBB
KKBKKRRBRR
KKBKKRRBRR
KKKBBBBRRR
KKKKKRRRRR
KKKKKRRRRR
