BBBBBBBBBB
RRRRRRRRRR
KKKKKKKKKK
KKKKKKKKKK
RRRRRRRRRR
BBBBBBBBBB
BKKBKKBKKB
BKKBKKBKKB
BBBBBBBBBB
RRRRRRRRRR
RRRRRRRRRR
BBBBBBBBBB
BBBBBBBBBB
BBBBBBBBBB
KKKKKKKKKK
KKKKKKKKKK
