KKKKKKKKKK
KBBKBBBBBK
KBBKBBBBBK
KKKKBKRKBK
KKKKBKKKBK
KKKKBBBBBK
KKKKKKKKKK
KKKKKKKKKK
KRRRRRRRRK
KRKKKKKKRK
KRKRRRRKRK
KRKRBBRKRK
KRKRRRRKRK
KRKKKKKKRK
KRRRRRRRRK
KKKKKKKKKK
