RRRRRRRRRR
RRRRRRRRRR
RRRRRRKRRR
RRRRRRKRRR
RRRRRRKRRR
YYYYYYKYYY
YYYYYYKYYY
WWWWWWKWWW
WWWWWWKWWW
WWWWWWKWWW
RRRRRRKRRR
RRRRKKKKKR
RRRRRKKKRR
RRRRRRKRRR
RRRRRRRRRR
RRRRRRRRRR
