KKKKKKKKKK
KKKKKKKKKK
KKKKKKKKKK
KKRRRRRRKK
KKRRRRRRKK
KKRRRRRRKK
WWYYYYYYWW
KKYYYYYYKK
KKYYYYYYKK
WWYYYYYYWW
KKRRRRRRKK
KKRRRRRRKK
KKRRRRRRKK
KKKKKKKKKK
KKKKKKKKKK
KKKKKKKKKK
