RRYYYKKKWW
RRYYYKKKWW
RRYYYKKKWW
RRYYYKKKKK
RYYYYKRRKK
RWWRRKRRKK
RWWRRKRRKK
RWWRRKKKKK
RYYRRKKKKK
KKYRRKRRYY
KKYRRKRRYY
KKYRRWRRYY
KRRYYKYYRR
KRRYYKYYRR
KRRYYKYYRR
KKKKKKYYRR
