KKKKKKKKKK
KKKKKKYKYK
KKKKKKKYKK
KKKKKKYKYK
RKKKKKKKKK
KRKKKKKKKK
KKRKKKKKKK
KKKRKKKKKK
KKKKRKKKKK
KKKKKRKKKK
KKKKKKRKKK
KKKKKKKRKK
KKKKKKKKRK
KKKKKKKKKR
KKKKKKKKKK
KKKKKKKKKK
