KKKKKKKKKK
KKKKKKYKYK
KKKKKKKYKK
KKKKKKYKYK
RKKKKKKKKK
KRKKKKKKKK
KKRKKKKKKK
RKKWKKKKKK
KRKKRKKKKK
KKWKKRKKKK
KKKRKKRKKK
KKKKRKKRKK
WWKKKRKKRK
WWKKKKRKKR
KKRRKKKRKK
KKRRKKKKKK
