KKKKKKKKKK
KKYKYKKKKK
KKKYKKKKKR
KKYKYKKKRK
KKKKKKKRKK
KKKKKKRKKK
KKKKKRKKKK
RKKKWKKKKK
KWKRKKYKYK
KKRKKKKYKK
KKKRKKYKYK
KKKKWKKKKK
KKKKKRKKKK
KKKKKKRKKK
KKKKKKKRKK
KKKKKKKKRK
