YYYYYYKYKK
YRRWKKWRRK
YRRWKKWRRY
YWWYKKYWWK
YRRRYYKKKY
RRKYKKYKKK
KKKYKKYKKK
KKKWRRWKKK
KKKWRRWKKK
KKKYKKYKKK
RRKYKKYKKK
YRRRYYKKKY
YWWYKKYWWK
YRRWKKWRRY
YRRWKKWRRK
YYYYYYKYKK
